10 10 1 1 8 8
0 0 0 0 0 0 0 0 0 0
0 1 10 0 0 0 0 0 0 0
0 15 5 1 5 1 5 1 0 0
0 0 1 0 0 0 0 15 0 0
0 0 5 0 0 0 0 1 0 0
0 0 1 0 0 0 0 5 0 0
0 0 5 0 0 0 0 1 0 0
0 0 1 25 1 10 1 5 10 0
0 0 0 0 0 0 0 15 1 0
0 0 0 0 0 0 0 0 0 0